12 12 12 12 12 12 12 12 12 12 12 12 12 12 12 
11  1  1  1  2  1  1  2  1  1  1  3  3  1  9 
11  2  1  1  1  1  2  1  2  1  4  1  1  3  9 
11  1  1  3  2  1  1  1  2  1  1  2  2  3  9 
11  6  3  3  4  1  1  1  1  1  1  1  1  1  9 
11  2  3  3  1  1  1  1  2  1  1  1  1  4  9 
11  3  3  2  2  1  1  1  2  1  1  1  1  1  9 
11  3  1  2  1  2  2  1  1  1  1  2  1  1  9 
11  1  1  5  1  1  1  2  1  1  1  2  2  1  9 
11  1  2  2  4  1  1  2  2  2  1  2  1  1  9 
11  1  1  1  1  1  1  1  2  1  1  1  2  2  9 
11  1  2  2  1  1  1  8  8  8  2  4  2  1  9 
11  2  1  1  1  2  1  8  7  8  1  1  1  1  9 
11  1  1  2  1  2  1  8  8  8  1  1  1  2  9 
11 10 10 10 10 10 10 10 10 10 10 10 10 10 10 
