 9  9  9  9  9  9  9  9  9  9  9  9  9  9 10 
12  8  8  8  1  1  1  1  1  1  1  4  2  1 10 
12  8  7  8  2  2  1  1  1  1  1  1  1  2 10 
12  8  8  8  1  1  2  1  1  1  1  1  1  1 10 
12  1  1  1  1  1  1  1  1  1  1  1  1  1 10 
12  1  2  1  1  2  1  1  1  1  2  1  1  1 10 
12  1  1  2  4  1  1  2  1  2  1  1  1  2 10 
12  1  1  2  1  3  3  1  2  2  1  1  1  4 10 
12  1  1  1  1  1  3  2  2  2  3  2  1  1 10 
12  1  1  1  1  1  1  3  5  2  3  2  1  1 10 
12  2  2  1  1  1  2  3  3  4  2  3  3  2 10 
12  2  2  2  1  1  1  3  1  2  4  3  3  1 10 
12  1  2  1  1  1  2  1  1  2  1  2  1  1 10 
12  1  1  1  6  1  1  1  2  1  1  2  1  1 10 
12 11 11 11 11 11 11 11 11 11 11 11 11 11 10 


 1  1  1  1  1  1  1  1  1  1  1  1  1  1  0 
 0  2  2  2  1  1  1  1  1  1  1  1  1  1  0 
 0  2  2  2  1  1  1  1  1  1  1  1  1  1  0 
 0  2  2  2  1  1  1  1  1  1  1  1  1  1  0 
 0  1  1  1  1  1  1  1  1  1  1  1  1  1  0 
 0  1  1  1  1  1  1  1  1  1  1  1  1  1  0 
 0  1  1  1  1  1  1  1  1  1  1  1  1  1  0 
 0  1  1  1  1  1  2  1  1  1  1  1  1  1  0 
 0  1  1  1  1  1  1  1  1  1  1  1  1  1  0 
 0  1  1  1  1  1  1  1  3  1  2  1  1  1  0 
 0  1  1  1  1  1  1  2  1  1  1  1  1  1  0 
 0  1  1  1  1  1  1  1  1  1  1  1  1  1  0 
 0  1  1  1  1  1  1  1  1  1  1  1  1  1  0 
 0  1  1  1  0  1  1  1  1  1  1  1  1  1  0 
 0  1  1  1  1  1  1  1  1  1  1  1  1  1  0 


 0  0  0  0  0  0  0  0  0  0  0  0  0  0  0 
 0  0  0  0  0  0  0  0  0  0  0  0  0  0  0 
 0  0  0  0  0  0  0  0  0  0  0  0  0  0  0 
 0  0  0  0  0  0  0  0  0  0  0  0  0  0  0 
 0  0  0  0  0  0  0  0  0  0  0  0  0  0  0 
 0  0  0  0  0  0  0  0  0  0  0  0  0  0  0 
 0  0  0  0  0  0  0  0  0  0  0  0  0  0  0 
 0  0  0  0  0  0  0  0  0  0  0  0  0  0  0 
 0  0  0  0  0  0  0  0  0  0  0  0  0  0  0 
 0  0  0  0  0  0  0  0  0  0  0  0  0  0  0 
 0  0  0  0  0  0  0  0  0  0  0  0  0  0  0 
 0  0  0  0  0  0  0  0  0  0  0  0  0  0  0 
 0  0  0  0  0  0  0  0  0  0  0  0  0  0  0 
 0  0  0  0  0  0  0  0  0  0  0  0  0  0  0 
 0  0  0  0  0  0  0  0  0  0  0  0  0  0  0 


 0  0  0  0  0  0  0  0  0  0  0  0  0  0  0 
 0  0  0  0  0  0  0  0  0  0  0  0  0  0  0 
 0  0  0  0  0  0  0  0  0  0  0  0  0  0  0 
 0  0  0  0  0  0  0  0  0  0  0  0  0  0  0 
 0  0  0  0  0  0  0  0  0  0  0  0  0  0  0 
 0  0  0  0  0  0  0  0  0  0  0  0  0  0  0 
 0  0  0  0  0  0  0  0  0  0  0  0  0  0  0 
 0  0  0  0  0  0  0  0  0  0  0  0  0  0  0 
 0  0  0  0  0  0  0  0  0  0  0  0  0  0  0 
 0  0  0  0  0  0  0  0  0  0  0  0  0  0  0 
 0  0  0  0  0  0  0  0  0  0  0  0  0  0  0 
 0  0  0  0  0  0  0  0  0  0  0  0  0  0  0 
 0  0  0  0  0  0  0  0  0  0  0  0  0  0  0 
 0  0  0  0  0  0  0  0  0  0  0  0  0  0  0 
 0  0  0  0  0  0  0  0  0  0  0  0  0  0  0 
