12  9  9  9  9  9  9  9  9  9  9  9  9  9  9 
12  2  1  2  1  2  6  2  2  1  2  1  2  1 10 
12  4  1  2  2  1  2  2  1  2  1  1  1  1 10 
12  2  1  1  1  1  1  1  1  1  4  1  1  1 10 
12  5  1  1  1  2  1  1  2  1  1  1  1  2 10 
12  1  2  1  1  2  1  1  1  1  2  1  1  2 10 
12  2  2  1  1  1  2  2  2  1  1  1  3  3 10 
12  4  1  8  8  8  1  1  2  1  2  1  3  3 10 
12  2  2  8  7  3  3  3  3  1  2  3  1  3 10 
12  1  2  8  8  8  3  3  1  3  1  2  1  2 10 
12  1  1  1  1  3  2  1  1  3  3  3  1  1 10 
12  1  2  2  1  4  2  2  1  3  1  3  3  2 10 
12  2  1  1  2  1  2  1  1  1  1  1  1  1 10 
12  1  1  2  1  2  1  1  4  2  1  1  1  1 10 
12 11 11 11 11 11 11 11 11 11 11 11 11 11 11 
