 9  9  9  9  9  9  9  9  9  9  9  9  9  9 10 
12  8  8  8  1  1  1  1  1  1  1  4  2  1 10 
12  8  7  8  2  2  1  1  1  1  1  1  1  2 10 
12  8  8  8  1  1  2  1  1  1  1  1  1  1 10 
12  1  1  1  1  1  1  1  1  1  1  1  1  1 10 
12  1  2  1  1  2  1  1  1  1  2  1  1  1 10 
12  1  1  2  4  1  1  2  1  2  1  1  1  2 10 
12  1  1  2  1  3  3  1  2  2  1  1  1  4 10 
12  1  1  1  1  1  3  2  2  2  3  2  1  1 10 
12  1  1  1  1  1  1  3  5  2  3  2  1  1 10 
12  2  2  1  1  1  2  3  3  4  2  3  3  2 10 
12  2  2  2  1  1  1  3  1  2  4  3  3  1 10 
12  1  2  1  1  1  2  1  1  2  1  2  1  1 10 
12  1  1  1  6  1  1  1  2  1  1  2  1  1 10 
12 11 11 11 11 11 11 11 11 11 11 11 11 11 10 


 1  1  1  1  1  1  1  1  1  1  1  1  1  1  0 
 0  2  2  2  1  1  1  1  1  1  1  1  1  1  0 
 0  2  2  2  1  1  1  1  1  1  1  1  1  1  0 
 0  2  2  2  1  1  1  1  1  1  1  1  1  1  0 
 0  1  1  1  1  1  1  1  1  1  1  1  1  1  0 
 0  1  1  1  1  1  1  1  1  1  1  1  1  1  0 
 0  1  1  1  1  1  1  1  1  1  1  1  1  1  0 
 0  1  1  1  1  1  2  1  1  1  1  1  1  1  0 
 0  1  1  1  1  1  1  1  1  1  1  1  1  1  0 
 0  1  1  1  1  1  1  1  3  1  2  1  1  1  0 
 0  1  1  1  1  1  1  2  1  1  1  1  1  1  0 
 0  1  1  1  1  1  1  1  1  1  1  1  1  1  0 
 0  1  1  1  1  1  1  1  1  1  1  1  1  1  0 
 0  1  1  1  0  1  1  1  1  1  1  1  1  1  0 
 0  1  1  1  1  1  1  1  1  1  1  1  1  1  0 


 0  1  1  1  1  1  1  1  1  1  1  1  1  1  0 
 0  0  0  0  0  0  0  0  0  0  0  0  0  0  0 
 0  0  0  0  0  0  0  0  0  0  0  0  0  0  0 
 0  0  0  0  0  0  0  0  0  0  0  0  0  0  0 
 0  0  0  0  0  0  0  0  0  0  0  0  0  0  0 
 0  0  0  0  0  0  0  0  0  0  0  0  0  0  0 
 0  0  0  0  0  0  0  0  0  0  0  0  0  0  0 
 0  0  0  0  0  0  0  0  0  0  0  0  0  0  0 
 0  0  0  0  0  0  0  0  0  0  0  0  0  0  0 
 0  0  0  0  0  0  0  0  0  0  0  0  0  0  0 
 0  0  0  0  0  0  0  0  0  0  0  0  0  0  0 
 0  0  0  0  0  0  0  0  0  0  0  0  0  0  0 
 0  0  0  0  0  0  0  0  0  0  0  0  0  0  0 
 0  0  0  0  0  0  0  0  0  0  0  0  0  0  0 
 0  0  0  0  0  0  0  0  0  0  0  0  0  0  0 


 0  0  0  0  0  0  0  0  0  0  0  0  0  0  0 
 0  0  0  0  0  0  0  0  0  0  0  0  0  0  0 
 0  0  0  0  0  0  0  0  0  0  0  0  0  0  0 
 0  0  0  0  0  0  0  0  0  0  0  0  0  0  0 
 0  0  0  0  0  0  0  0  0  0  0  0  0  0  0 
 0  0  0  0  0  0  0  0  0  0  0  0  0  0  0 
 0  0  0  0  0  0  0  0  0  0  0  0  0  0  0 
 0  0  0  0  0  0  0  0  0  0  0  0  0  0  0 
 0  0  0  0  0  0  0  0  0  0  0  0  0  0  0 
 0  0  0  0  0  0  0  0  0  0  0  0  0  0  0 
 0  0  0  0  0  0  0  0  0  0  0  0  0  0  0 
 0  0  0  0  0  0  0  0  0  0  0  0  0  0  0 
 0  0  0  0  0  0  0  0  0  0  0  0  0  0  0 
 0  0  0  0  0  0  0  0  0  0  0  0  0  0  0 
 0  0  0  0  0  0  0  0  0  0  0  0  0  0  0 


 0  0  0  0  0  0  0  0  0  0  0  0  0  0  0 
 0  0  0  0  0  0  0  0  0  0  0  0  0  0  0 
 0  0  0  0  0  0  0  0  0  0  0  0  0  0  0 
 0  0  0  0  0  0  0  0  0  0  0  0  0  0  0 
 0  0  0  0  0  0  0  0  0  0 -1464448800  0  0  0  5 
 0 1994752  0  0  0  0  0  0  0  0  0  0  0  0  0 
 0 32544 -1294041392 21852  0 32544 2147479968  1 -1296238764 32544 -1464447872  0  0 32765  1 
 0 4096  0  0  0  0 21852 -1294049184  0  0  0  0 32544 -1464447889  0 
-1294041392  0 4063235  0 4194314  0 560  0 1826128  0  1  0 1993376  6 4093472 
 0 2009984  0  8  0 68  0 4093472  0 1685382480  0 23004  6  0 32765 
-1464446960 32544  0 32544 -1296212389 32765 -1464446720 32544 -1294044816 32544  1  0 -1300436372 32544 -1464446784 
32544 -1294151680  0 -1294149256  0 -1294149256  0 -1296308031 32765  0  0 -1300422424  0 -1464061368  0 
-1464446352 32544 -1296258311 32544 -1294151680 32765  0 32544 -1296307948 32544 -1294046736  0 39  0  0 
4521 -1294044816 32765  0 32544 -1294146304 32544 -1464061224 32544  2 32765  0  0  0 32544 
-1294043376 32544  0  0  0 32765  0  0 -1294043376  0  9 32765 -583661987  0 -1464445568 
